NO img/BMTH.png
SO img/ST.png
WE img/BO.png
EA img/DPM.png
C 66,66,66
F 116,16,02

 1111111111111
100000000001001
100100000W00001
100000010000001
 1111111111111
