
NO img/n.png
SO img/s.png
WE img/o.png
EA img/e2.png
F 240,191,112
C 112,206,231

11111111111111111111111
100000000000000000000001
100000000000000000000001
100000000000000000000001
100000000011111000000001    
100000000100000100000001
1000000000100E0100000001
111000000001111000000001      111
101000000000000000000001      101
111111111111111111111111       1

111111111111111111111111
100000000000000000000001
111111111111111111111111
