
NO ./path_to_the_north_texture
SO ./path_to_the_south_texture   

   WE ./path_to_the_west_texture
EA ./path_to_the_east_texture   
    F        1,2,255
C 0,2,255

        111111111111111111111111
        1000000000110000000E00101
        1011000001110000000000011
111111111011000001110000000000001
100000000011000001110111111111111
11110111111111011100000010001
11110111111111011101010010001
11000000011010101110000E10001    1111   
10000000000000001100000010001    1011   
10000000000000001101010010001    111 
1100000111010101111101111000111  
11110111 1110101 101111010001
11111111 1111111 111111111111
