
NO img/n.png
SO img/s.png
WE img/o.png
EA img/e2.png
F 240,191,112
C 112,206,231

        1111111111111111111111111
        1000000000110000000000001
        101100000111000000N000001
111111111011000001110000000000001
100000000011000001110111111111111
11110111111111000000000010001
11110111111111000000010010001
11000000011010001110000000001    1111   
10000000000000001100000N00001    1011   
10000000000000000001010000001    111 
1100000111010101111101111000111  
11110111 1110101 101111010001
11111111 1111111 111111111111
