NO img/retro-cassette.png
SO img/retro-vhs.png
WE img/retro-vinyl.png
EA img/retro-floppy.png
F 70,0,95
C 190,0,156

  1111111111111
111000010001001
100100000S00011
100000110001001 1111
110110010011111 1001
100000010000001 111
111111111111111

111111
100001
111111
