NO img/n.png
SO img/s.png
WE img/o.png
EA img/e.png
F 240,191,112
C 112,206,231

11111111111
1000N000001
11111111111
