NO img/retro-cassette.png
SO img/retro-vhs.png
WE img/retro-vinyl.png
EA img/retro-floppy.png
F 70,0,95
C 190,0,156

111111111111111
100000000001001
100100000N00001
100000010000001
111111111111111
