NO img/town.png
SO img/town.png
WE img/town.png
EA img/town.png
C 51,0,102
F 156,0,156

111111111111111
100000000001001
100100000N00001
100000010000001
111111111111111
