NO img/town-n.png
SO img/town-s.png

WE img/town-o.png
EA img/town-e.png
 F 0,0,0
C 190,0,156

 111111111111111  1111111111111
100000000001001111000000001001
100000000000000000000000010001
100000010000001111111001000111
111111111111111111111111111111